Condition,Age,Sex,SexCoded,Pre,Post,Change
A,20,F,1,80,80,0
A,22,M,0,120,180,60
A,23,M,0,30,30,0
A,23,F,1,240,300,60
A,30,M,0,0,30,30
B,21,F,1,60,60,0
B,22,M,0,90,90,0
B,21,M,0,60,100,40
B,25,F,1,90,90,0
B,32,M,0,60,60,0
C,22,M,0,30,45,15
C,22,M,0,100,115,15
C,21,M,0,180,240,60
C,24,M,0,40,75,35
C,34,M,0,60,70,10
C,30,F,1,180,195,15
